XXXXXXXXXXXXXXXXXXXXXXXXXXXXXXXXXXXXXXXXXXXXXXXXXXXXXXXXXXXXXXXXXXXXXXXXXXXXXXXXXXXXXXXXXXXXXXXXXXXXXXXXXXXXXXXXXXXXXXXXXXXXXXXXXXXXXXXXXXXXXXXXXXXXXXXXXXXXXXXXXXXXXXXXXXXXXXXXXXXXXXXXXXXXXXXXXXXXXXXXXXXXXXXXXXXXXXXXXXXXXXXXXXXXXXXXXXXXXXXXXXXXXXXXXXXXXXXX
XXXXXXXXXXXXXXXXXXXXXXXXXXXXXXXXXXXXXXXXXXXXXXXXXXXXXXXXXXXXXXXXXXXXXXXXXXXXXXXXXXXXXXXXXXXXXXXXXXXXXXXXXXXXXXXXXXXXXXXXXXXXXXXXXXXXXXXXXXXXXXXXXXXXXXXXXXXXXXXXXXXXXXXXXXXXXXXXXXXXXXXXXXXXXXXXXXXXXXXXXXXXXXXXXXXXXXXXXXXXXXXXXXXXXXXXXXXXXXXXXXXXXXXXXXXXXXXX
XXXXXXXXXXXXXXXXXXXXXXXXX.....XXXXXXXXXXXXXXXXXXX..XXXXXXXXXXXXXXXXXXXXXXXX....XXXX...........XXXXXXXXX..XXXXXXXXXXXXXXXXXXXXXXXXXXXXXX..XXXXXXXXXXX.........XXXXX............XXXXX...........XXXXXXXXXX....XXX...XXXX....XXXXXXXXXXXXXXXXXXXXXXXX............XX
XXXXXXXXXXXXXXXXXX.XXXXXX.....XXXXXXXXXXXX..XXXXX...XXXXXXXXXXXXXXXXXXXXXX..........XX....XX...XXXXX......XXXXXXXXXXXXXXXXXXXXXXXXXX......XXXXXXX.....X.......XXX..XXXXXXXXX...XXX....XXX......XXXXXXXX.....XX.....XX......XXXXXXXXXXXXXXXXXXXXXXX..XX.XXX.XX.XX
XXXXXXXXXXXXXXXXX..XXXXXX......XXXXXXXXXXX...XXXX....XXXXXXXXXXXXXXXXXXXX..........XXXX..XXXX..XXXX.......XXXXXXXXXXXXX..XXXXXXXXXX.......XXXXXXX....X.........XX..XXXXXXXXX...XX..X.XXXXX.X...XXXXXXXX.....................XXXXXXXXXXXXXXXXXXXXXX..XX.XXX.XX.XX
XXXXXXX....................................................XXXXXXX....XX...........XXXX..XXXX.......................................................X.X.X.X.X..XX..XXXXXXXXX...XX..............XXXXXX.........................XXXXXXX.XXXXXXXXXXXX............XX
XXXXXXX.XXXXXXXXX..............XXXX.XXXXXX...........XXXXX.XXXXXX..................XXXX..XXXX..XXXX.......XXXXXXXXXX.XX..XXXXXXXXXX.......XXXXXXX....X.........XX..XXXXXXXXX...XX..X.X...X.X...XXXXXX.X........................XXXXXX.XXXXXXXXXXXX............XX
XXXXXXX.XXXXXXXXXX............XXXXX.XXXXXX..........XXXXXX.XXXXXX..............................XXXXX......XXXXXXXXXX.XXXXXXXXXXXXXXX......XXXXXXX.....X.......XXX.....X........XXX.............XXXXXX.X.....XX.....XX..........XXXXXX.XXXXXXXXXXXX............XX
XXXXXXX.XXXXXXXXXX............XXXXX.XXXXXXX........XXXXXXX.XXXXXXX....XX.......XXXX...........XXXXXXXXX..XXXXXXXXXXX.XXXXXXXXXXXXXXXXXX..XXXXXXXXXXX.........XXXXX....X.......XXXXX...........XXXXXXX.XX....XXX...XXXX........XXXXXXX.XXXXXXXXXXXX............XX
XXXXXXX.XXXXXXXXXXXXXXX.XXXXXXXXXXX.XXXXXXXXXXXXXXXXXXXXXX.XXXXXXXXXXXXXXXXXXXXXXXXXXXXXXXXXXXXXXXXXXXXXXXXXXXXXXXXX.XXXXXXXXXXXXXXXXXXXXXXXXXXXXXXXXXXXXXXXXXXXXXXXXXXXXXXXX.XXXXXXXXX.XXXXXXXXXXXXX.XXXXXXXXXXXXXXXXXXXXXXX.XXXXXXX.XXXXXXXXXXXXXXXXXX.XXXXXXX
XXXXXXX.XXXXXXXXXXXXXXX.XXXXXXXXXXX.XXXXXXXXXXXXXXXXXXXXXX.XXXXXXXXXXXXXXXXXXXXXXXXXXXXXXXXXXXXXXXXXXXXXXXXXXXXXXXXX.XXXXXXXXXXXXXXXXXXXXXXXXXXXXXXXXXXXXXXXXXXXXXXXXXXXXXXXX.XXXXXXXXX.XXXXXXXXXXXXX.XXXXXXXXXXXXXXXXXXXXXXX.XXXXXXX.XXXXXXXXXXXXXXXXXX.XXXXXXX
XXXXXXX.XXXXXXXXXXXXXXX.XXXXXXXXXXX.XXXXXXXXXXXXXXXXXXXXXX.XXXXXXXXXXXXXXXXXXXXXXXXXXXXXXXXXXXXXXXXXXXXXXXXXXXXXXXXX.XXXXXXXXXXXXXXXXXXXXXXXXXXXXXXXXXXXXXXXXXXXXXXXXXXXXXXXX.XXXXXXXXX.XXXXXXXXXXXXX.XXXXXXXXXXXXXXXXXXXXXXX.XXXXXXX.XXXXXXXXXXXXXXXXXXXXXXXXXX
XXXXXXX.XXXXXXXXXXXXXXX.XXXXXXXXXXX.XXXXXXXXXXXXXXXXXXXXXX.XXXXXXXXXXXXXXXXXXXXXXXXXXXXXXXXXXXXXXXXXXXXXXXXXXXXXXXXX.XXXXXXXXXXXXXXXXXXXXXXXXXXXXXXXXXXXXXXXXXXXXXXXXXXXXXXXX.XXXXXXXXX.XXXXXXXXXXXXX.XXXXXXXXXXXXXXXXXXXXXXX.XXXXXXX.XXXXXXXXXXXXXXXXXXXXXXXXXX
XXX...........................XXXXX.XXXX...........XXXXXXX.XXXX...............XXXXXXXXXX..XX..XXXX..XX..XXXXXXX...XX.XXXXXXXXXXXXXXXXXXXXXXXXXXXXXXXXXXXXXXXXXXXXXXXXXXXXXXXX.XXXXX..........XXXXX..................XXXXXXXXX.XXXXXXX.XXXX....................XX
XX..X......XX..XX..XX.......X..XXXX.XXX..XX.XX.XX...XXXXXX.XXX.................XXXXXXXXX................XXXXXX.....X.XXXXXXXXXXXXXXXXXXXXXXXXXXXXXXXXXXXXXXXXXXXXXXXXXXXXXXXX.XXXX...X........XXX....................XXXXXXXX.XXXXXXX.XXX.........XX.XXX..XX..XX
X.....X....XX..XX..XX.....X....XXXX.XX...XX.XX.XX....XXXXX.XX......X..X..X...X.XXXXXXXXX................XXXXX......X.XXXXXXXXXXXXXXXXXXXXXXXXXXXXXXXXXXXXXXXXXXXXXXXXXXXXXXXX.XXXX.X....X.X...XXX......X.X.X.X.......XXXXX.............XX.........XX.XXX..XX..XX
X...X...X...............X...X..XXX...............................................XX..XX...............................X..............................................................X......X......................X.XX.......................................XX
X.....X.....XX....XX......X....XX.........XX.XX....................X..X..X...X.............................XX.........X........................................................XXX.X....X.X...XXX......X.X.X.X.......X...XXXXXXXXXXXXXXXX...........XX..XX.XX.XX
XX..X.......XX....XX........X..XX.........XX.XX............................................................XXX........X.................XXXXXXXXXXXXXXXXXXXXXXXXXXXXXXX........XXX...X........XXX....................X...XXXXXXXXXXXXXXXX...........XX..XX.XX.XX
XXX...........................XXXX...............................................XX..XX...XX..XXXX..XX.....XXXX.......X.................XXXXXXXXXXXXXXXXXXXXXXXXXXXXXXX........XXXX..........XXXXX..................XXX..XXXXXXXXXXXXXXXX.....................XX
XXXXXXXXXXXXXXXXXXXXXXXXXXXXXXXXXXXXXXXXXXXXXXXXXXXXXXXXXXXXXXXXXXXXXXXXXX.XXXXXXXX.XXXXXXXXX.XXXXXXXXXXXXXXXXXXXXXXXXX....XXXXXXXXXXXXXXXXXXXXXXXXXXXXXXXXXXXXXXXXXXXXXXXXXXXXXXXXXXXX.XXXXXXXXXXX.XXXXXXXXXXXXXX.XXXX..XXXXXXXXXXXXXXXXXXXXXXXXXXXXXXXXXXXXXXX
XXXXXXXXXXXXXXXXXXXXXXXXXXXXXXXXXXXXXXXXXXXXXXXXXXXXXXXXXXXXXXXXXXXXXXXXXX.XXXXXXXX.XXXXXXXXX.XXXXXXXXXXXXXXXXXXXXXXXXX....XXXXXXXXXXXXXXXXXXXXXXXXXXXXXXXXXXXXXXXXXXXXXXXXXXXXXXXXXXXX.XXXXXXXXXXX.XXXXXXXXXXXXXX.XXXX..XXXXXXXXXXXXXXXXXXXXXXXXXXXXXXXXXXXXXXX
XXXXXXXXXXXXXXXXXXXXXXXXXXXXXXXXXXXXXXXXXXXXXXXXXXXXXXXXXXXXXXXXXXXXXXXXXX.XXXXXXXX.XXXXXXXXX.XXXXXXXXXXXXXXXXXXXXXXXXX....XXXXXXXXXXXXXXXXXXXXXXXXXXXXXXXXXXXXXXXXXXXXXXXXXXXXXXXXXXXXXXXXXXXXXXXX.XXXXXXXXXXXXXX.XXXX..XXXXXXXXXXXXXXXXXXXXXXXXXXXXXXXXXXXXXXX
XXXXXXXXXXXXXXXXXXXXXXXXXXXXXXXXXXXXXXXXXXXXXXXXXXXXXXXXXXXXXXXXXXXXXXXXXX.XXXXXXXX.XXXXXXXXX.XXXXXXXXXXXXXXXXXXXXXXXXX....XXXXXXXXXXXXXXXXXXXXXXXXXXXXXXXXXXXXXXXXXXXXXXXXXXXXXXXXXXXXXXXXXXXXXXXX.XXXXXXXXXXXXXX.XXXX..XXXXXXXXXXXXXXXXXXXXXXXXXXXXXXXXXXXXXXX
XXX...........................XXXX............XXXX.....XXXX........XX.........................XXXX...XXXX.XXXXXXXXXXXXX....XXX................X.............................................................XXXXXX.X.....XXXXXXXXXXXXXXXXXXXXXXXX............XXX
XX.X..X..X..X......X..X..X..X.XXXX....XXXX....XXX.......XX.....................................XX.....XX..XXXXXXXXXXXXX....XXX.............X..........................................................XXXX..XXXXXX.X.....XXXXXXXXXXXXXXXXXXXXXXXX.XX.XXX.XX..XXX
XX............................XXXX.XXXXXXXXXX.XXX...X...XX........X..X..X..X..X...X..X..X..X...XX.....................X......................X.......................................................XXXXXX.XXXXXX.X.....XXXXXXXXXXXXXXXXXXXXXXXX.XX.XXX.XX..XXX
XX.X..X..X..X......X..X..X..X.XXXX............XXX..X.X..XX.....................................XX.....................X....................X.........................................................XXXXXX..............................XXXXXXXX............XXX
XX............................XXXX.XXX....XXX.XXX...X...XX........X..X..X..X..X...X..X..X..X...XX........XXXXXXXXXXXXXXXXXXXXXXXXXXXXXX......X.......................................................XXXXXX..............................XXXXXXXX............XXX
XX.X..X..X..X......X..X..X..X.XXXX............XXX.......XX.....................................XX.....XX.XXXXXXXXXXXXXXXXXXXXXXXXXXXXXX....X.............................................................................................XXXXXXXX............XXX
XX............................XXXX............XXXX.....XXXX........XX.........................XXXX...XXXXXXXXXXXXXXXXXXXXXXXXXXXXXXXXXX.......X..........................................................................................XXXXXXXX............XXX
XX............XXXX............XXXXXXXXX.XXXXXXXXXXXXXX.XXXXXX.XXXXXXXXXXXXXXXXXXXXXX.XXXXXXXXXXXXX..XXXXXXXXXXXXXXXXXXXXXXXXXXXXXXXXXXX..XXXXXXXXXXXXXXXXXXXXXXXXX.............XX.............XXXXXXXXXXXXXXXXXXXXXXXXX..XXXXXXXXX.......XXXXXXXXXXXXX.XXXXXXXXX
XX............XXXX............XXXXXXXXX.XXXXXXXXXXXXXX.XXXXXX.XXXXXXXXXXXXXXXXXXXXXX.XXXXXXXXXXXXX..XXXXXXXXXXXXXXXXXXXXXXXXXXXXXXXXXXX..XXXXXXXXXXXXXXXXXXXXXXXXX.............XX.............XXXXXXXXXXXXXXXXXXXXXXXXX..XXXXXXXXX.......XXXXXXXXXXXXX.XXXXXXXXX
XX............XXXX............XXXXXXXXX.XXXXXXXXXXXXXX.XXXXXX.XXXXXXXXXXXXXXXXXXXXXX.XXXXXXXXXXXXX..XXXXXXXXXXXXXXXXXXXXXXXXXXXXXXXXXXX..XXXXXXXXXXXXXXXXXXXXXXXXX.............XX.............XXXXXXXXXXXXXXXXXXXXXXXXX..XXXXXXXXX.......XXXXXXXXXXXXXXXXXXXXXXX
XX............XXXX............XXXXXXXXX.XXXXXXXXXXXXXX.XXXXXX.XXXXXXXXXXXXXXXXXXXXXX.XXXXXXXXXXXXX..XXXXXXXXXXXXXXXXXXXXXXXXXXXXXXXXXXX..XXXXXXXXXXXXXXXXXXXXXXXXX.............XX.............XXXXXXXXXXXXXXXXXXXXXXXXX..XXXXXXXXX.......XXXXXXXXXXXXXXXXXXXXXXX
XX............................XXXXXXXXX.X..XXXXXXX............XXXX............XXXXXX.XXXXXXXXXXXXX..XXXXXXXXXXXXXX............XXXXXXXXX...X....XXX............XXXX............................XXXXX...........XXX..............XXX.......XXXXXXXXXXXXXXXXXXXXXXX
XX.X..X..X..X......X..X..X..X.XXXX..XXX.X...XXXXXX............XXX.............XXXXXX.XXXXXXXXXXXXX..XXXXXXXXXXXXXX.XX.XXX.XX..XXXXXXXXX........XX....XXXXXX....XXX............................XXXX....XXX......XX.X.X......X...XXX.......XXXXXXXXXXXXXXXXXXXXXXX
XX...................................XX.X....XXXXX.X.X.X.X.X..XXX.X.X.X........XXXXX.....................XXXXXXXXX.XX.XXX.XX..XXXXXXXXX.....X..XX..X.XXXXXX.X..XXX............................XXX..X.XXXXX.X...XX.....X..X...X.XXX.......XXXXXXXXXXXXX.XXXXXXXXX
XX.X..X..X..X......X..X..X..X.................................XXX..............XXXXX.....................XXXXXXXXX.............................XX....XXXXXX....XXX............................XXX..............XX.X.X......X...XXX.......................XXXXXXX
XX...........................................XXXXX.X.X.X.X.X..XXX.X.X.X..XXXXXXXXXXXXXXXXXXXXXXXXXXXXXXXXXXXXXXXXX..XX...XX...XXXXXXXXX.....X..XX..X.XXXXXX.X..XXX............................XXX..X.X...X.X...XX............X.XXX.......................XXXXXXX
XX.X..X..X..X......X..X..X..X.XXXX...........XXXXX............XXX........XXXXXXXXXXXXXXXXXXXXXXXXXXXXXXXXXXXXXXXXX..XX...XX...XXXXXXXXX........XX..............XXX............................XXXX.............XX.X.X......X...XXX.......................XXXXXXX
XX............................XXXXX..........XXXXX............XXXX.......XXXXXXXXXXXXXXXXXXXXXXXXXXXXXXXXXXXXXXXXX............XXXXXXXXX...X....XXX............XXXX............................XXXXX...........XXX..............XXXX......................XXXXXXX
XX............XXXX............XXXXXXXXXXXXXXXXXXXXXXXXXXXXXXXXXXXXXXXXXX.XXXXXXXXXXXXXXXXXXXXXXXXXXXXXXXXXXXXXXXXXXXXXXXXXXXXXXXXXXXXXX..XXXXXXXXXXXXXX..XXXXXXXXXXXXXX..XXXXXXXXXXXXXXXXXXX..XXXXXXXXX.XXXXXXXXX.X.X.X..X.X.X.XXXXXXXXXXXXXXXXXXXXXX....XXXXXXX
XX............XXXX............XXXXXXXXXXXXXXXXXXXXXXXXXXXXXXXXXXXXXXXXXX.XXXXXXXXXXXXXXXXXXXXXXXXXXXXXXXXXXXXXXXXXXXXXXXXXXXXXXXXXXXXXX..XXXXXXXXXXXXXX..XXXXXXXXXXXXXX..XXXXXXXXXXXXXXXXXXX..XXXXXXXXX.XXXXXXXXX.X.X.X..X.X.X.XXXXXXXXXXXXXXXXXXXXXX....XXXXXXX
XX............XXXX............XXXXXXXXXXXXXXXXXXXXXXXXXXXXXXXXXXXXXXXXXX.XXXXXXXXXXXXXXXXXXXXXXXXXXXXXXXXXXXXXXXXXXXXXXXXXXXXXXXXXXXXXX..XXXXXXXXXXXXXX..XXXXXXXXXXXXXX..XXXXXXXXXXXXXXXXXXX..XXXXXXXXX.XXXXXXXXX.X.X.X..X.X.X.XXXXXXXXXXXXXXXXXXXXXX....XXXXXXX
XX............XXXX............XXXXXXXXXXXXXXXXXXXXXXXXXXXXXXXXXXXXXXXXXX.XXXXXXXXXXXXXXXXXXXXXXXXXXXXXXXXXXXXXXXXXXXXXXXXXXXXXXXXXXXXXX..XXXXXXXXXXXXXX..XXXXXXXXXXXXXX..XXXXXXXXXXXXXXXXXXX..XXXXXXXXX.XXXXXXXXX.X.X.X..X.X.X.XXXXXXXXXXXXXXXXXXXXXX....XXXXXXX
XX............................XXXX............XXXX............XXXX.......XXXXXXXXX............XXXXXXXXXXXXXXXXXXXXXXXXXXXXXXXXXXXXXXXXX......XXXXX...XX..XXXXXXXXXX..........XXXX.........XX..XXXX....X.XXX..XXXX..............XXX............XXXXXX.....XXXXXXX
XX.X..X..X..X......X..X..X..X.XXX....XXXXXX....XX....XXXXXX....XX........XXXXXXXXX..XX.XXX.XX.XXXXXXXXXXXXXXXXXXXXXXXXXXXXXXXXXXXXXXXXX......XXXXX...XX..XXXXXXXXX............XXX.....X...XX..XXXX....X.XXX..XXXX.....X....X...XX..............XXXXX.....XXXXXXX
XX............................XXX..X.XXXXXX.X..XX..X.XXXXXX.X..XX..X.X...XXXXXXXXX..XX.XXX.XX.XXXXXXXXXXXXXXXXXXXXXXXXXXXXXXXXXXXXXXXXX......XXXXX...................X....X.............X.XX..XXX.....X.XXX..XXX..X.X....X...X.......X....X....XXXXX.....XXXXXXX
XX.X..X..X..X......X..X..X..X.XXX....XXXXXX....XX....XXXXXX....XX........XXXXXXXXX............XXXXXXXXX......................................XXXXX.X..............................X...X...XX..XXX.....................X....X...................XXXX......X.X.XXX
XX............................XXX..X.XXXXXX.X..XX..X.XXXXXX.X..XX..X.X...XXXXXXXXX............XXXXXXXXX......................................XXXXX...................X....X.............X.XX..XXX............XXX..X.X....X...X.................XXX.......XXXXXXX
XX.X..X..X..X......X..X..X..X.XXX..............XX..............XX........XXXXXXXXX............XXXXXXXXX..XXXXXXXXXXXXXXXXXXXXXXXXXX..........XXXXX...XX..XXXXXXXXX............XXX.....X...XX..XXXX...........XXXX.....X....X...XX..............XXX.......XXXXXXX
XXX...........................XXXX............XXXX............XXXX.......XXXXXXXXX............XXXXXXXXX..XXXXXXXXXXXXXXXXXXXXXXXXXX..........XXXXX...XX..XXXXXXXXXX..........XXXX.........XX..XXXX...........XXXX..............XXX............XXXXX......XXXXXXX
XXXXXXXXXXXXXX.XXXXXXXXXXXXXXXXXXXXXXXX..XXXXXXXXXXXXXX..XXXXXXXXXXXXXX..XXXXXXXXXXXXXXX.XXXXXXXXXXXXXX..XXXXXXXXXXXXXXXXXXXXXXXXXXXXXX..XXXXXXXXXXXXXX..XXXXXXXXXXXXXXXXXXXXXXXX.X...X.X.XX..XXXXXXXXXXXXXXXXXXXXX.XXXXXXXX.XXXXXXXXXXXXXXXXXXXXXXXX....XXXXXXX
XXXXXXXXXXXXXX.XXXXXXXXXXXXXXXXXXXXXXXX..XXXXXXXXXXXXXX..XXXXXXXXXXXXXX..XXXXXXXXXXXXXXX.XXXXXXXXXXXXXX..XXXXXXXXXXXXXXXXXXXXXXXXXXXXXX..XXXXXXXXXXXXXX..XXXXXXXXXXXXXXXXXXXXXXXX.X...X.X.XX..XXXXXXXXXXXXXXXXXXXXX.XXXXXXXX.XXXXXXXXXXXXXXXXXXXXXXXX....XXXXXXX
XXXXXXXXXXXXXX.XXXXXXXXXXXXXXXXXXXXXXXX..XXXXXXXXXXXXXX..XXXXXXXXXXXXXX..XXXXXXXXXXXXXXXXXXXXXXXXXXXXXX..XXXXXXXXXXXXXXXXXXXXXXXXXXXXXX..XXXXXXXXXXXXXX..XXXXXXXXXXXXXXXXXXXXXXXX.X...X.X.XX..XXXXXXXXXXXXXXXXXXXXX.XXXXXXXX.XXXXXXXXXXXXXXXXXXXXXXXX....XXXXXXX
XXXXXXXXXXXXXX.XXXXXXXXXXXXXXXXXXXXXXXX..XXXXXXXXXXXXXX..XXXXXXXXXXXXXX..XXXXXXXXXXXXXXXXXXXXXXXXXXXXXX..XXXXXXXXXXXXXXXXXXXXXXXXXXXXXX..XXXXXXXXXXXXXX..XXXXXXXXXXXXXXXXXXXXXXXX.X...X.X.XX..XXXXXXXXXXXXXXXXXXXXX.XXXXXXXX.XXXXXXXXXXXXXXXXXXXXXXXX....XXXXXXX
XXXXXXXXXXXXXX.XXX..........XXXXXX............................XXXX.......XXXXXXXXXXXXXXXXXXXXXXXXXXXXXX........................................XXXXXXXX..XXXXXXXXXX..........................................XXXXXX.XXXXXXXX.XXXXX......XXXX..XXXXXX.....XXXXXXX
XXXXXXXXXXXXXX.XX...........XXXXXX..XXXXXXXXXXXXXX.............XXX...X...XXXXXXXXXXXXXXXXXXXXXXXXXXXXXX................X.X...X.XX.X...X..X.X...XXXXXXXX..XXXXXXXXXX.......................X....XXXXXXXXXXXXX.XXXXXX.XXXXXXXX.XXXX........XX....XXXXX.....XXXXXXX
XXXXXXXXXXXXXX.XX..X.X.X.X..........XXXXXXXXXXXXXX....X..................XXXXXXXXXXXXXXX.XXXXXXXXXXXXXX...X.XX...............................................................X....X...X.X......XXXXXXXXXXXXX........................X.......X..XXXXX.....XXXXXXX
XX.............XX...................XXXXXXXXXXXXXX........X..........X...............XX............................X.X.X.X.X.X.XX.X.X.X..X.X.X............................................X....XXXXXXXXXXXXX...................................XXXX......X.X.XXX
XX.............XX..X.X.X.X..........XXXXXXXXXXXXXX....X.......................XXXX...XX.......XXXXX.......X.XX...........................................XXXXXXXXXXXXXX......X....X...X.X......XXXXXXXXXXXXX........................X.......X..XXX.......XXXXXXX
XX.............XX...........XXXXXX..XXXXXXXXXXXXXX.............XXX...X........XXXX...XX.......XXXXX....................X.X...X.XX.X...X..X.X...XXXXXXXX..XXXXXXXXXXXXXX...................X....XXXXXXXXXXXXX.XXXXXX.XXXXXXXX.XXXX........XX....XXX.......XXXXXXX
XX.............XXX..........XXXXXX............................XXXX............XXXX...XX.......XXXXX............................................XXXXXXXX..XXXXXXXXXXXXXX..............................XXXXXXX.XXXXXX.XXXXXXXX.XXXXX......XXXX..XXXXX......XXXXXXX
XX............XXXXXXXXXXXX..XXXXXXXXX..XX.....XXXXXX..X...X.X.XXXXX..XXXX..XX.XXXX...XX...X.X.XXXXXXXXXXXXXXXXXXXXXXXXXXXXXXXXXXXXX.X.X..X.X.X.XXXXXXXX..XXXXXXXXXXXXXX....XXX.XX.X...X.X.XX.XXXXXXX.XXXXXXX.XXXXXX.XXXXXXXX.XXXXXXXXXXXXXXXXXXXXXXXX....XXXXXXX
XX............XXXXXXXXXXXX..XXXXXXXXX..XX.....XXXXXX..X...X.X.XXXXX..XXXX..XX.XXXX...XX...X.X.XXXXXXXXXXXXXXXXXXXXXXXXXXXXXXXXXXXXX.X.X..X.X.X.XXXXXXXX..XXXXXXXXXXXXXX....XXX.XX.X...X.X.XX.XXXXXXX.XXXXXXX.XXXXXX.XXXXXXXX.XXXXXXXXXXXXXXXXXXXXXXXX....XXXXXXX
XX............XXXXXXXXXXXX..XXXXXXXXX..XX.....XXXXXX..X...X.X.XXXXX..XXXX..XX.XXXX...XX...X.X.XXXXXXXXXXXXXXXXXXXXXXXXXXXXXXXXXXXXX.X.X..X.X.X.XXXXXXXX..XXXXXXXXXXXXXX....XXX.XX.X...X.X.XX.XXXXXXX.XXXXXXX.XXXXXX.XXXXXXXX.XXXXXXXXXXXXXXXXXXXXXXXX....XXXXXXX
XX............XXXXXXXXXXXX..XXXXXXXXX..XX.....XXXXXX..X...X.X.XXXXX..XXXX..XX.XXXX...XX...X.X.XXXXXXXXXXXXXXXXXXXXXXXXXXXXXXXXXXXXX.X.X..X.X.X.XXXXXXXX..XXXXXXXXXXXXXX....XXX.XX.X...X.X.XX.XXXXXXX.XXXXXXX.XXXXXX.XXXXXXXX.XXXXXXXXXXXXXXXXXXXXXXXX....XXXXXXX
XX............XXXXXXXXXXXX..XXXXXXXXX...X.....XXXX............XXXXX..................XX.......................XXXX.......XX...XXXX.............XXX.......XXXXXXXXXXXXXX.......................XXXXXX.XX...................X..XXXXX.......................XXXXXXX
XX.............XXXXXXXXXXX..XXXXXXXXX...X..........X......X....XXX...................XX...X........XXXX........XX..X.X......X..XX...X....X...X.XX....X...XXXXXXXXXXXXXX...................X....XXXXX.X.......XXXXX..XXXXXXXX.XXXX..XXX...................XXXXXXX
XX......................................X.............X...............X..............XX.....X...........XXX.......................X...............X......XXXXXXXXXXXXXX.....X.....X...X.X............X.......XXXXX..XXXXXXXX..............XXXX...........XXXXXXX
XX......................................X..........X......X.X.............................X........XXXX............X.X......X.......X.X..X.X.X.......X....................................X..........X.......XXXXX..XXXXXXXX.......XXX.XX................XXXXXXX
XX......................................X.............X...............X..............XX.....X...........XXX.......................X...............X.........................X.....X...X.X............X.......XXXXX..XXXXXXXX..............XXXX...........XXXXXXX
XX.............XXXXXXXXXXX..XXXXXXXXXX..XXXXXX.....X......X....XXX...................XX...X........XXXX........XX..X.X......X..XX...X....X...X.XX....X....................................X....XXXXXXX.......XXXXX..XXXXXXXXXXXXX..XXX...................XXXXXXX
XX............XXXXXXXXXXXX..XXXXXXXXXX..XXXXXXXXXX............XXXXX..................XX.......................XXXX.......XX...XXXX.............XXX............................................XXXXXXXXX.............XXXXXXXXXXXXXX.......................XXXXXXX
XXXXXXXXXXXXXXXXXXXXXXXXXX..XXXXXXXXXX..XXXXXXXXXXXXXXX...X.X.XXXXXXXXXXXXXXXXXXXXXX.XXXXXXXXXXXXXXXXXXXXXXX..XXXXXXXXX..XXXXXXXXXX.X.X..X.X.X.XXXXXXXXXXXXXXXXXXXXXXXXXXXXXXXXXXXXXXXXXXXX...XXXXXXXXXXXXXXXXXXXXXXXXXXXXXXXXXXXXXXXXXXXXXXXXXXXXXXX....XXXXXXX
XXXXXXXXXXXXXXXXXXXXXXXXXX..XXXXXXXXXX..XXXXXXXXXXXXXXX...X.X.XXXXXXXXXXXXXXXXXXXXXX.XXXXXXXXXXXXXXXXXXXXXXX..XXXXXXXXX..XXXXXXXXXX.X.X..X.X.X.XXXXXXXXXXXXXXXXXXXXXXXXXXXXXXXXXXXXXXXXXXXX...XXXXXXXXXXXXXXXXXXXXXXXXXXXXXXXXXXXXXXXXXXXXXXXXXXXXXXX....XXXXXXX
XXXXXXXXXXXXXXXXXXXXXXXXXX..XXXXXXXXXX..XXXXXXXXXXXXXXX...X.X.XXXXXXXXXXXXXXXXXXXXXX.XXXXXXXXXXXXXXXXXXXXXXX..XXXXXXXXX..XXXXXXXXXX.X.X..X.X.X.XXXXXXXXXXXXXXXXXXXXXXXXXXXXXXXXXXXXXXXXXXXX...XXXXXXXXXXXXXXXXXXXXXXXXXXXXXXXXXXXXXXXXXXXXXXXXXXXXXXX....XXXXXXX
XXXXXXXXXXXXXXXXXXXXXXXXXX..XXXXXXXXXX..XXXXXXXXXXXXXXX...X.X.XXXXXXXXXXXXXXXXXXXXXX.XXXXXXXXXXXXXXXXXXXXXXX..XXXXXXXXX..XXXXXXXXXX.X.X..X.X.X.XXXXXXXXXXXXXXXXXXXXXXXXXXXXXXXXXXXXXXXXXXXX...XXXXXXXXXXXXXXXXXXXXXXXXXXXXXXXXXXXXXXXXXXXXXXXXXXXXXXX....XXXXXXX
XXXX.........................XXXXXXXXX........................XXXX............XXXX...XX.......................XXXXXX.....XXXXXXXXX...............XXXXX......XXXXXXXXXXX..XXXXXXXXXXXXXX...........................................XXXXXXXXXXXXXXXXXXX....XXXXXXX
XXX..XX.XX....................XXXXXXXXXXXXXXXXXXXXXXXXX........XX......XXX.....XX....XX.X...X...........X.....XXXXX......XXXXXXXXX....X..X.X.X....XXXX.......XXXXXXX......XXXXXXXXXXXX............................................XXXXXXXXXXXXXXXXXXX....XXXXXXX
XX...XX.XX........................XXXXXXXXXXXXXXXXXXXXX.............X.XXXXX.X..XX....XX...X...............X....XXX.......XXXXXXXX.X.X..............XXX...X...XXXXXX.......XXXXXXXXXXX....................................................................XXXXXXX
X.....................................XXXXXXXXXXXXXXXXX...X....................XX..X.XX.X...X.....X..X..X.............................X..X.X.X......XX..X.X..............................................................................................XXXXXXX
XX....XX.XX...........................XXXXXXXXXXXXXXXXX.............X.X...X.X..XX....XX...X...............X....XXX............XXX.X.X....................X...XXXXXX.......XXXXXXXXXXX..XXXXXXXXXXXXXXXXXXXXXXXXXXXXXXXXXXXXXXXXXXXXXXXXXXXXXXXXXXXXXXXXXXXXXXXXX
XXX...XX.XX...................XXXX....XXXXXXXXXXXXXXXXX........XX..............XX....XX.X...X...........X.....XXXX............XXXX....X..X.X.X...............XXXXXXX......XXXXXXXXXXXX.XXXXXXXXXXXXXXXXXXXXXXXXXXXXXXXXXXXXXXXXXXXXXXXXXXXXXXXXXXXXXXXXXXXXXXXXX
XXXX.........................XXXXX............................XXXX............XXXX...XX.......................XXXX............XXXX..................XX......XXXXXXXXXXX..XXXXXXXXXXXXXXXXXXXXXXXXXXXXXXXXXXXXXXXXXXXXXXXXXXXXXXXXXXXXXXXXXXXXXXXXXXXXXXXXXXXXXXX
XXXXXXXXXXXXXXXXXXXXXXXXXXXXXXXXXXXXXXXXXXXXXXXXXXXXXXXXXXXXXXXXXXXXXXXXXXXXXXXXXXXXXXXXXXXXXXXXXXXXXXXXXXXXXXXXXXXXXXXXXXXXXXXXXXXXXXXXXXXXXXXXXXXXXXXXXXXXXXXXXXXXXXXXXXXXXXXXXXXXXXXXXXXXXXXXXXXXXXXXXXXXXXXXXXXXXXXXXXXXXXXXXXXXXXXXXXXXXXXXXXXXXXXXXXXXXXXX
XXXXXXXXXXXXXXXXXXXXXXXXXXXXXXXXXXXXXXXXXXXXXXXXXXXXXXXXXXXXXXXXXXXXXXXXXXXXXXXXXXXXXXXXXXXXXXXXXXXXXXXXXXXXXXXXXXXXXXXXXXXXXXXXXXXXXXXXXXXXXXXXXXXXXXXXXXXXXXXXXXXXXXXXXXXXXXXXXXXXXXXXXXXXXXXXXXXXXXXXXXXXXXXXXXXXXXXXXXXXXXXXXXXXXXXXXXXXXXXXXXXXXXXXXXXXXXXX
